agr: AGR
api: API
biojupies: Biojupies
cad: CAD
copdgene: COPDGene
coronary artery disease: CAD
coronary artery diseases: CAD
CADs: CAD
cram: CRAM
cwl: CWL
dbgap: dbGaP
fair: FAIR
fairshake: FAIRshake
gds: GDS
grm: GRM
gtex: GTEx
guid: GUID
guids: GUIDs
hdl: HDL
igv: IGV
json: JSON
jupyter: Jupyter
kcs: KCs
manhattan: Manhattan plot
nih: NIH
pcs: PCS
python: Python
qc: QC
qq: Quantile
rna-seq: RNA-Seq
sra: SRA
sexual: sex
topmed: TOPMed
uid: UID
uids: UIDs
vcf: VCF
wgsa: WGSA
